1111111111111111111111111111111111111
1000000000000000C00000000000000111111
1000000000000000C00000000000000111111
1000000E00000000C00000000000000111111
1000000000000000C0000000000000P111111
1000000000000000C00000000000000111111
1111111111111111111111111111111111111