11111111111111111111111111111111
1000000P00000000CN00000000000001
100000000000000NC100000000000001
1000C000000000000000010000000001
1000C000000000000100010000000001
10000000000000000100010000000001
10000000000000000100010000E00001
11111111111111111111111111111111